- - - - - - - - - P P P P P
| . R . . . . . . P . . . P
| R . R . . R . . P . . . P
| . . . . . . . . P . Z . P
| . . . . . . . . P P . P P
| . . . . . . . . . . . . |
| . . . . . . . . . . . . |
| . . . . . R . . . R . . |
| . R . . . . . . . . . . |
- - - - - - - - - - - - - -