T T T T T T T T T P P P P P
T . R . . . . . . P G M . P
T R . R . . R . . P . . . P
T . . . . . . . . P . Z . P
T . . . . . . . . P P . P P
T . W . . . . . . . . . . T
T . . . . . . . . . . . . T
T . . . . . R . . . R . . T
T . R . . . . . . . . . . T
T T T T T T T T T T T T T T